0 0 0 0 0 0 0 0 0 0
0 0 1 0 0 0 0 0 0 0
0 0 1 0 0 0 0 0 0 0
0 0 1 1 0 0 0 0 0 0
0 0 0 1 0 0 0 0 0 0
0 0 0 1 0 0 0 0 0 0
0 0 0 1 0 0 0 0 0 1
0 0 0 1 1 1 0 0 1 1
0 0 0 0 0 1 0 0 1 0
0 0 0 0 0 1 1 1 1 1
19
1 2
2 2
3 2
3 3
4 3
5 3
6 3
7 3
7 4
7 5
8 5
9 5
9 6
9 7
9 8
8 8
7 8
7 9
6 9
18.00